accumulators -> array assert circular_buffer concept_check config core fusion iterator mpl numeric~conversion numeric~ublas parameter preprocessor range serialization static_assert throw_exception tuple type_traits typeof
algorithm -> array assert bind concept_check config core exception function iterator mpl range regex static_assert throw_exception tuple type_traits unordered
align -> assert config core static_assert
any -> config core static_assert throw_exception type_index type_traits
array -> assert config core static_assert throw_exception
asio -> array assert bind chrono config core coroutine date_time function regex smart_ptr system throw_exception type_traits utility
assert -> config
assign -> array config core move mpl preprocessor ptr_container range static_assert throw_exception tuple type_traits
atomic -> align assert config static_assert type_traits winapi
beast -> asio assert bind config container core endian intrusive logic mp11 optional smart_ptr static_assert system throw_exception type_traits utility winapi
bimap -> concept_check config container_hash core iterator lambda mpl multi_index preprocessor property_map serialization static_assert throw_exception type_traits utility
bind -> config core
callable_traits ->
chrono -> assert config core integer move mpl predef ratio static_assert system throw_exception type_traits typeof utility winapi
circular_buffer -> assert concept_check config core move static_assert throw_exception type_traits
compatibility ->
compute -> algorithm array assert chrono config core filesystem function function_types fusion iterator lexical_cast mpl optional preprocessor property_tree proto range smart_ptr static_assert thread throw_exception tuple type_traits typeof utility uuid
concept_check -> config preprocessor static_assert type_traits
config ->
container -> assert config core intrusive move static_assert type_traits winapi
container_hash -> assert config core detail integer static_assert type_traits
context -> assert config core pool predef smart_ptr
contract -> any assert config core exception function function_types mpl optional preprocessor smart_ptr static_assert thread type_traits typeof utility
conversion -> assert config core smart_ptr throw_exception type_traits typeof
convert -> config core function_types lexical_cast math mpl optional parameter range spirit type_traits
core -> assert config static_assert
coroutine -> assert config context core exception move system throw_exception type_traits utility
coroutine2 -> assert config context
crc -> array config integer type_traits
date_time -> algorithm assert config core io lexical_cast numeric~conversion range smart_ptr static_assert throw_exception tokenizer type_traits utility winapi
detail -> config core preprocessor static_assert type_traits
dll -> assert config core filesystem function move predef smart_ptr spirit static_assert system throw_exception type_index type_traits winapi
dynamic_bitset -> assert config container_hash core integer move static_assert throw_exception
endian -> config core static_assert type_traits
exception -> assert config core smart_ptr throw_exception tuple type_traits
fiber -> assert config context core intrusive predef smart_ptr
filesystem -> assert config container_hash core detail io iterator smart_ptr system type_traits
flyweight -> assert config container_hash core detail interprocess mpl multi_index parameter preprocessor serialization smart_ptr throw_exception type_traits
foreach -> config core iterator mpl range type_traits
format -> assert config core optional smart_ptr throw_exception utility
function -> assert bind config core integer preprocessor throw_exception type_index type_traits typeof
function_types -> config core detail mpl preprocessor type_traits
functional -> config core function function_types mpl preprocessor type_traits typeof utility
fusion -> config container_hash core function_types mpl preprocessor static_assert tuple type_traits typeof utility
geometry -> algorithm array assert concept_check config container core function_types fusion integer iterator lexical_cast math move mpl multiprecision numeric~conversion polygon qvm range rational serialization smart_ptr static_assert thread throw_exception tokenizer tuple type_traits utility variant
gil -> assert concept_check config core filesystem integer iterator mp11 numeric~conversion preprocessor variant2
graph -> algorithm any array assert bimap bind concept_check config container_hash conversion core detail foreach function integer iterator lexical_cast math move mpl multi_index optional parameter preprocessor property_map property_tree random range serialization smart_ptr spirit static_assert throw_exception tti tuple type_traits typeof unordered utility xpressive
graph_parallel -> assert concept_check config container_hash core detail dynamic_bitset filesystem foreach function graph iterator lexical_cast mpi mpl optional property_map random serialization smart_ptr static_assert tuple type_traits variant
hana -> config core fusion mpl tuple
heap -> array assert bind concept_check config core intrusive iterator parameter static_assert throw_exception type_traits
histogram -> config core mp11 serialization throw_exception variant2
hof ->
icl -> assert concept_check config container core date_time detail iterator move mpl range rational static_assert type_traits utility
integer -> assert config core static_assert throw_exception
interprocess -> assert config container core date_time integer intrusive move static_assert type_traits unordered winapi
intrusive -> assert config container_hash core move static_assert
io -> config
iostreams -> assert config core detail function integer iterator mpl preprocessor random range regex smart_ptr static_assert throw_exception type_traits utility
iterator -> assert concept_check config conversion core detail function_types fusion mpl optional smart_ptr static_assert type_traits utility
json -> align assert config container exception system throw_exception utility
lambda -> bind config core detail iterator mpl preprocessor tuple type_traits utility
leaf ->
lexical_cast -> array assert config container core integer numeric~conversion range static_assert throw_exception type_traits
local_function -> config mpl preprocessor scope_exit type_traits typeof utility
locale -> assert config function iterator smart_ptr static_assert type_traits
lockfree -> align array assert atomic config core integer iterator mpl parameter predef static_assert tuple type_traits utility
log -> array assert atomic config container core date_time exception filesystem function_types fusion intrusive iterator lexical_cast locale move mpl optional parameter phoenix predef preprocessor property_tree proto range regex smart_ptr spirit static_assert system thread throw_exception type_index type_traits utility winapi xpressive
logic -> config core
math -> algorithm array assert atomic concept_check config core detail integer lambda lexical_cast predef random range smart_ptr static_assert throw_exception type_traits
metaparse -> config mpl predef preprocessor static_assert type_traits
move -> assert config core static_assert winapi
mp11 ->
mpi -> assert config core foreach function graph integer iterator mpl optional python serialization smart_ptr static_assert throw_exception type_traits
mpl -> config core predef preprocessor static_assert type_traits utility
msm -> any assert bind circular_buffer config core function fusion mpl parameter phoenix preprocessor proto serialization tuple type_traits typeof
multi_array -> array assert concept_check config core functional iterator mpl static_assert type_traits
multi_index -> assert bind config container_hash core foreach integer iterator move mpl preprocessor serialization smart_ptr static_assert throw_exception tuple type_traits utility
multiprecision -> array assert config container_hash core integer lexical_cast math predef random rational throw_exception
nowide -> config filesystem
numeric~conversion -> config conversion core mpl preprocessor throw_exception type_traits
numeric~interval -> config detail logic
numeric~odeint -> array assert bind compute config core function fusion iterator math mpi mpl multi_array numeric~ublas preprocessor range static_assert throw_exception type_traits units utility
numeric~ublas -> compute concept_check config core iterator mpl numeric~interval range serialization smart_ptr static_assert type_traits typeof
optional -> assert config core detail move predef static_assert throw_exception type_traits utility
outcome -> config exception system throw_exception
parameter -> config core function fusion mp11 mpl optional preprocessor type_traits utility
parameter_python -> mpl parameter preprocessor python
pfr ->
phoenix -> assert bind config core function fusion mpl predef preprocessor proto range smart_ptr type_traits utility
poly_collection -> assert config core iterator mp11 mpl type_erasure type_traits
polygon -> config
pool -> assert config integer throw_exception type_traits winapi
predef ->
preprocessor ->
process -> algorithm asio config core filesystem fusion iterator move optional system tokenizer type_index winapi
program_options -> any config core detail function iterator lexical_cast smart_ptr static_assert throw_exception type_traits
property_map -> any assert bind concept_check config core function iterator lexical_cast mpi mpl multi_index optional serialization smart_ptr static_assert throw_exception type_traits utility
property_tree -> any assert bind config core format iterator mpl multi_index optional range serialization static_assert throw_exception type_traits
proto -> config core fusion mpl preprocessor range static_assert type_traits typeof utility
ptr_container -> array assert circular_buffer config core iterator mpl range serialization smart_ptr static_assert type_traits unordered utility
python -> bind config conversion core detail foreach function iterator lexical_cast mpl numeric~conversion preprocessor smart_ptr static_assert tuple type_traits utility
qvm ->
random -> array assert config core dynamic_bitset integer io range static_assert system throw_exception type_traits utility
range -> array assert concept_check config container_hash core detail iterator mpl numeric~conversion optional preprocessor regex static_assert tuple type_traits utility
ratio -> config core integer mpl rational static_assert type_traits
rational -> assert config core integer static_assert throw_exception type_traits utility
regex -> assert concept_check config container_hash core integer iterator mpl predef smart_ptr static_assert throw_exception type_traits
safe_numerics -> concept_check config core integer logic mp11
scope_exit -> config function preprocessor type_traits typeof
serialization -> array assert config core detail integer io iterator move mpl optional predef preprocessor smart_ptr spirit static_assert type_traits unordered utility variant
signals2 -> assert bind config core function iterator mpl optional parameter predef preprocessor smart_ptr throw_exception tuple type_traits variant
smart_ptr -> assert config core move static_assert throw_exception type_traits
sort -> config core range static_assert type_traits
spirit -> array assert config core endian foreach function function_types fusion integer io iterator move mpl optional phoenix pool preprocessor proto range regex smart_ptr static_assert thread throw_exception type_traits typeof unordered utility variant
stacktrace -> array config container_hash core predef static_assert type_traits winapi
statechart -> assert bind config conversion core detail function mpl smart_ptr static_assert thread type_traits
static_assert -> config
static_string -> assert container_hash static_assert throw_exception utility
stl_interfaces -> assert config
system -> config winapi
test -> algorithm assert bind config core detail exception function io iterator mpl numeric~conversion optional preprocessor smart_ptr static_assert type_traits utility
thread -> assert atomic bind chrono concept_check config container container_hash core date_time exception function intrusive io iterator move optional predef preprocessor smart_ptr static_assert system throw_exception tuple type_traits utility winapi
throw_exception -> assert config
timer -> chrono config core system
tokenizer -> assert config iterator mpl throw_exception type_traits
tti -> config function_types mpl preprocessor type_traits
tuple -> config core static_assert type_traits
type_erasure -> assert config core fusion iterator mp11 mpl preprocessor smart_ptr throw_exception type_traits typeof vmd
type_index -> config container_hash core preprocessor static_assert throw_exception type_traits
type_traits -> config static_assert
typeof -> config preprocessor type_traits
units -> assert config core integer io lambda math mpl preprocessor serialization static_assert type_traits typeof
unordered -> assert config container container_hash core detail move predef preprocessor smart_ptr throw_exception tuple type_traits
utility -> config container_hash core io preprocessor throw_exception type_traits
uuid -> assert config container_hash core io move numeric~conversion predef random serialization static_assert throw_exception tti type_traits winapi
variant -> assert bind config container_hash core detail integer move mpl preprocessor static_assert throw_exception type_index type_traits utility
variant2 -> config mp11
vmd -> preprocessor
wave -> assert concept_check config core filesystem iterator lexical_cast mpl multi_index optional pool preprocessor serialization smart_ptr spirit static_assert throw_exception type_traits
winapi -> config predef
xpressive -> assert config conversion core exception fusion integer iterator lexical_cast mpl numeric~conversion optional preprocessor proto range smart_ptr static_assert throw_exception type_traits typeof utility
yap -> hana preprocessor type_index
